{...}	Означает блок. Блоки обычно используются в функциях и командах Else, Loop и IF.	0
AutoTrim	Определяет, удаляют ли операторы SetEnv и "var = value" пробелы и табуляции из начала и конца строки.	On|Off
BlockInput	Запрещает или позволяет пользователю взаимодействовать с компьютером при помощи клавиатуры, мыши и других устройств ввода.	on|off|send|mouse|sendandmouse|default|mousemove|mousemoveoff
Break	Выводит из цикла (завершает цикл). Команда действительна только внутри цикла.	0
ClipWait	Ожидает момента поступления данных в буфер обмена.	SecondsToWait,1
Continue	Пропускает остаток текущей итерации цикла и начинает новую. Команда действительна только внутри цикла.	0
Control	Вносит различные изменения в элементы управления.	 Check|Uncheck|Enable|Disable|Show|Hide|Style|ExStyle|ShowDropDown|HideDropDown|TabLeft|TabRight|Add|Delete|Choose|ChooseString|EditPaste, Value,Control,WinTitle,WinText,ExcludeTitle,ExcludeText
ControlClick	Посылает элементу управления события кнопки и колеса мыши.	|Control|Pos,WinTitle,WinText,WhichButton, ClickCount, |NA|D|U|Pos|X&Ycoord,ExcludeTitle,ExcludeText
ControlFocus	Устанавливает фокус ввода на заданный элемент управления окна.	Control,WinTitle,WinText,ExcludeTitle,ExcludeText
ControlGet	Извлекает различную информацию об элементе управления.	OutputVar, List|Checked|Enabled|Visible|Tab|FindString|Choice|LineCount|CurrentLine|CurrentCol|Line|Selected|Style|ExStyle|Hwnd, Value,Control,WinTitle,WinText,ExcludeTitle,ExcludeText
ControlGetFocus	Извлекает элемент управления целевого окна, имеющий фокус ввода (если таковой имеется).	OutputVar,WinTitle,WinText,ExcludeTitle,ExcludeText
ControlGetPos	Извлекает позицию и размер элемента управления.	X, Y, Width, Height,Control,WinTitle,WinText,ExcludeTitle,ExcludeText
ControlGetText	Извлекает текст из элемента управления.	OutputVar,Control,WinTitle,WinText,ExcludeTitle, ExcludeText
ControlMove	Перемещает элемент управления или изменяет его размеры.	Control, X, Y, Width, Height,WinTitle,WinText,ExcludeTitle,ExcludeText
ControlSend	Посылает окну или элементу управления эмулированные нажатия клавиш.	Control, Keys,WinTitle,WinText,ExcludeTitle,ExcludeText
ControlSendRaw	Посылает окну или элементу управления эмулированные нажатия клавиш.	Control, Keys,WinTitle,WinText,ExcludeTitle,ExcludeText
ControlSetText	Изменяет текст в элементе управления.	Control, NewText,WinTitle,WinText,ExcludeTitle,ExcludeText
CoordMode	Устанавливает режим координат различных команд на соответствие активному окну или экрану.	ToolTip|Pixel|Mouse|Caret|Menu, Screen|Relative
Critical	Не позволяет другим потокам прерывать текущий поток.	Off
DetectHiddenText	Определяет "видим" ли невидимый текст в окне в целях нахождения этого окна. Данная команда воздействует на такие команды, как IfWinExist и WinActivate.	On|Off
DetectHiddenWindows	Определяет "видит" ли скрипт невидимые окна.	On|Off
DllCall(	Вызывает изнутри DLL функцию (например, стандартную функцию Windows API).	Result, DllFile,Function, Type1, Arg1, Type2, Arg2, "Cdecl ReturnType")
Drive	Выдвигает/задвигает поддон CD или DVD-привода или задает метку тома диска.	Label|Lock|Unlock|Eject,Drive, Value
DriveGet	Извлекает различную информацию о диске (дисках) компьютера.	OutputVar, Cmd, Value
DriveSpaceFree	Извлекает свободное пространство на диске в мегабайтах.	OutputVar,Path
Edit	Открывает скрипт для редактирования в ассоциированном редакторе.	0
Else	Если результатом IF-оператора является FALSE, определяет команду(ы) для исполнения. Если определено несколько команд, сформируйте из них блок (заключите в фигурные скобки).	0
EnvAdd	Задает переменной значение, равное сумме значения самой переменной и данного значения (может также прибавлять или вычитать время из значения дата-время (date-time)). Синоним: var += value	Var, Value,TimeUnits
EnvDiv	Задает переменной значение, равное результату деления самой переменной на данное значение. Синоним: var /= value	Var, Value
EnvMult	Задает переменной значение, равное произведению самой переменной и данного значения. Синоним: var *= value	Var, Value
EnvSet	Присваивает значение переменной, содержащейся в среде.	EnvVar, Value
EnvSub	Задает переменной значение, равное разности самой переменной и заданного значения (может также сравнивать значения даты-времени (date-time)). Синоним: var -= value	Var, Value,TimeUnits
EnvUpdate	Оповещает операционную систему и все запущенные приложения об изменении переменной окружения.	0
Exit	Завершает текущий поток или весь скрипт (если скрипт завершает работу автоматически и не содержит горячих клавиш).	ExitCode
ExitApp	Безусловно завершает скрипт.	ExitCode
FileAppend	Добавляет в конец файла текст (при необходимости сначала создав файл).	Text,Filename
FileCopy	Копирует один или несколько файлов.	SourcePattern,DestPattern,1
FileCopyDir	Копирует папку вместе с подпапками и файлами (похоже на xcopy).	Source,Dest,1
FileCreateDir	Создает папку.	DirName
FileCreateShortcut	Создает ярлык (.lnk-файл).	Target,LinkFile,WorkingDir, Args, Description,IconFile, ShortcutKey, IconNumber, RunState
FileDelete	Удаляет один или несколько файлов.	FilePattern
FileInstall	Включает в скомпилированный скрипт заданные файлы.	SourcePattern,DestPattern,1
FileGetAttrib	Сообщает атрибуты папки или файла (только для чтения, скрытый и т.д.).	OutputVar,Filename
FileGetShortcut	Извлекает информацию о ярлыке (.lnk-файле), например, его целевой файл.	LinkFile, OutTarget, OutDir, OutArgs, OutDescription, OutIcon, OutIconNum, OutRunState
FileGetSize	Извлекает размер файла.	OutputVar,Filename, |K|M
FileGetTime	Извлекает дату-время изменения файла или папки.	OutputVar,Filename, M|C|A
FileGetVersion	Извлекает версию файла.	OutputVar,Filename
FileMove	Перемещает или переименовывает один или несколько файлов.	SourcePattern,DestPattern,1
FileMoveDir	Перемещает папку вместе с подпапками и файлами. Может также переименовывать папку.	Source,Dest, |1|2|R
FileRead	Считывает в переменную весь текст файла.	OutputVar,Filename
FileReadLine	Считывает определенную строку из файла и сохраняет текст в переменной.	OutputVar,Filename, LineNum
FileRecycle	Посылает, если возможно, файл или каталог в корзину.	FilePattern
FileRecycleEmpty	Очищает корзину.	DriveLetter
FileRemoveDir	Удаляет папку.	DirName,1
FileSelectFile	Отображает стандартный диалог, позволяющий пользователю выбирать файл(ы).	OutputVar, Options,RootDir|Filename, Prompt, Filter
FileSelectFolder	Отображает стандартный диалог, позволяющий пользователю выбрать папку.	OutputVar,StartingFolder, Options, Prompt
FileSetAttrib	Изменяет атрибуты одного или нескольких файлов или папок. Поддерживает групповые символы.	Attributes,FilePattern, |1|2,1
FileSetTime	Изменяет дату-время изменения одного или нескольких файлов или папок. Поддерживает групповые символы.	YYYYMMDDHH24MISS,FilePattern, WhichTime, |1|2,1
FormatTime	Преобразует временную метку YYYYMMDDHH24MISS в заданный формат даты/времени.	OutputVar,YYYYMMDDHH24MISS,Format
GetKeyState	Проверяет, нажата или отпущена клавиша клавиатуры или кнопка мыши/джойстика. Извлекает также статус джойстика.	OutputVar, KeyName, |P|T
Gosub	Переходит к заданной метке и продолжает выполнение до команды Return.	Label
Goto	Переходит к заданной метке и продолжает выполнение.	Label
GroupActivate	Активирует следующее окно в группе окон, заданных командой GroupAdd.	GroupName,R
GroupAdd	Добавляет спецификацию окна в группу окон, при необходимости создавая группу.	GroupName,WinTitle,WinText, Label,ExcludeTitle,ExcludeText
GroupClose	Закрывает активное окно, если оно было только что активировано командами GroupActivate или GroupDeactivate. Затем активирует следующее окно в последовательности. Может также закрыть все окна группы.	GroupName, A|R
GroupDeactivate	Похоже на команду GroupActivate, однако активирует следующее окно не в группе.	GroupName,R
GUI	Создает и управляет окнами и элементами управления. Подобные окна можно использовать в качестве форм ввода данных или собственных пользовательских интерфейсов.	add|show|submit|cancel|destroy|font|color|margin|menu|flash|default, Param2, Param3, Param4
GuiControl	Вносит различные изменения в элемент управления в окне GUI.	|Text|Move|MoveDraw|Focus|Disable|Enable|Hide|Show|Delete|Choose|ChooseString|Font|+Option|-Option,ControlID, Param3
GuiControlGet	Извлекает различную информацию об элементе управления в окне GUI.	OutputVar, |Pos|Focus|FocusV|Enabled|Visible,ControlID, Param4
HideAutoItWin	(Устарела – эквивалент данной команды: Menu, tray, NoIcon|Icon)	On|Off
Hotkey	Создает, изменяет, блокирует, разблокирует горячую клавишу во время работы скрипта.	KeyName*Label*Options|IfWinActive*WinTitle*WinText
if	Если сравнение переменной со значением истинно (TRUE), задает команду(ы) для исполнения. Если команд несколько, сформируйте из них блок (заключите в фигурные скобки).	(expression)
IfEqual	Проверяет, равна ли переменная значению. Синоним: if var = value | if var <> value	var, value
IfNotEqual	Проверяет, равна ли переменная значению. Синоним: if var = value | if var <> value	var, value
IfExist	Проверяет существование файла или папки.	FilePattern
IfNotExist	Проверяет существование файла или папки.	FilePattern
IfGreater	Сравнивает переменную со значением. Синоним: if var > value | if var >= value	var, value
IfGreaterOrEqual	Сравнивает переменную со значением. Синоним: if var > value | if var >= value	var, value
IfInString	Проверяет, содержит ли переменная заданную строку.	var, SearchString
IfLess	Сравнивает переменную со значением. Синоним: if var < value | if var <= value	var, value
IfLessOrEqual	Сравнивает переменную со значением. Синоним: if var < value | if var <= value	var, value
IfMsgBox	Проверяет, какую кнопку нажал пользователь во время последенй команды MsgBox.	ButtonName
IfWinActive	Проверяет, существует ли заданное окно и активно ли оно в момент проверки (на переднем плане).	WinTitle,WinText,ExcludeTitle,ExcludeText
IfWinNotActive	Проверяет, существует ли заданное окно и активно ли оно в момент проверки (на переднем плане).	WinTitle,WinText,ExcludeTitle,ExcludeText
IfWinExist	Проверяет, существует ли заданное окно.	WinTitle,WinText,ExcludeTitle,ExcludeText
IfWinNotExist	Проверяет, существует ли заданное окно.	WinTitle,WinText,ExcludeTitle,ExcludeText
ImageSearch	Осуществляет поиск изображения в области экрана.	OutputVarX, OutputVarY, X1, Y1, X2, Y2,ImageFile
IniDelete	Удаляет значение из стандартного формата .ini-файла.	Filename, Section, Key
IniRead	Считывает значение из стандартного формата .ini-файла.	OutputVar,Filename, Section, Key,Default
IniWrite	Присваивает значение стандартного формата .ini-файла.	Value,Filename, Section, Key
Input	Ожидает, пока пользователь печатает строку (не поддерживается в Windows 9x).	OutputVar, Options, EndKeys, MatchList
InputBox	Отображает окно для ввода данных, приглашая пользователя напечатать строку.	OutputVar, Title, Prompt, |HIDE, Width, Height, X, Y, Font, Timeout, Default
KeyHistory	Отображает информацию о скрипте и историю последних нажатий клавиш и кликов мыши.	0
KeyWait	Ожидает, когда будет нажата или отпущена клавиша или кнопка мыши/джойстика.	KeyName,|D|L|T
ListHotkeys	Отображает на экране горячие клавиши, используемые текущим скриптом, информацию о том, запущены ли их подпрограммы и используют ли они обработчик клавиатурных прерываний или кликов мыши.	0
ListLines	Отображает последние выполненные строки скрипта.	0
ListVars	Отображает переменные скрипта: их имена и текущее содержимое.	0
Loop	Многократно выполняет ряд команд: заданное количество раз или до команды break.	Count
Menu	Создает, удаляет, изменяет и отображает меню и пункты меню. Изменяет иконку трея и всплывающую подсказку иконки трея. Проверяет, можно ли открыть главное окно скомпилированного скрипта.	MenuName, Cmd,P3,P4,P5,FutureUse
MouseClick	Нажимает или удерживает кнопку мыши, или прокручивает колесико мыши.	WhichButton, X, Y, ClickCount, Speed, |D|U, R
MouseClickDrag	Нажимает и удерживает заданную кнопку мыши, перемещает мышь к заданным координатам, затем отпускает кнопку.	WhichButton, X1, Y1, X2, Y2, Speed,R
MouseGetPos	Извлекает текущую позицию курсора мыши и, по желанию, окно или элемент управления, над которым он находится.	OutputVarX, OutputVarY, OutputVarWin, OutputVarControl, |1|2|3
MouseMove	Перемещает курсор мыши.	X, Y, Speed,R
MsgBox	Отображает заданный текст в маленьком окне с одной или несколькими кнопками (например, с кнопками Yes и No).	Options, Title, Text, Timeout
OnExit	Определяет подпрограмму, которая будет запущена автоматически, когда скрипт будет завершать работу.	Label,FutureUse
OnMessage	Определяет функцию, которая будет запущена автоматически при получении скриптом заданного сообщения.	(MsgNumber, "FunctionName")
OutputDebug	Посылает строку в отладчик (если таковой существует) для отображения.	Text
Pause	Приостанавливает текущий поток скрипта.	On|Off|Toggle,1
PixelGetColor	Извлекает цвет пиксела, находящегося в заданных координатах экрана x,y.	OutputVar, X, Y, |Alt|Slow|RGB
PixelSearch	Ищет в области экрана пиксел определенного цвета.	OutputVarX, OutputVarY, X1, Y1, X2, Y2,ColorID, Variation, |Fast|RGB
PostMessage	Помещает сообщение в очередь сообщений окна или элемента управления.	Msg, wParam, lParam,Control,WinTitle,WinText,ExcludeTitle,ExcludeText
Process	Выполняет над процессом следующие операции: проверяет, существует ли процесс; изменяет его приоритет; закрывает его; ждет, пока он закроется.	Exist|Close|Priority|Wait|WaitClose, |PID|Name, Param3
Progress	Создает или обновляет окно, содержащее индикатор выполнения.	ProgressParam1, SubText, MainText, WinTitle,FontName,FutureUse
Random	Создает псевдослучайное число.	OutputVar*Min*Max|NewSeed
RegDelete	Удаляет из реестра подключ или значение.	RootKey, SubKey, ValueName
RegRead	Считывает из реестра значение.	OutputVar, RootKey, SubKey, ValueName
RegWrite	Записывает значение в реестр.	ValueType, RootKey, SubKey, ValueName, Value
Reload	Заменяет текущий запущенный экземпляр скрипта на новый.	0
Return	Осуществляет возврат из подпрограммы, вызванной функцией, командой Gosub, активацией горячей клавиши, командой GroupActivate или другими способами.	Expression
Run	Запускает внешнюю программу.	Target,WorkingDir, |Max|Min|Hide|UseErrorLevel, OutputVarPID
RunAs	Задает параметры доступа пользователя для последующего использования команд Run и RunWait. Требует Windows 2000/XP или более поздних версий.	User, Password, Domain
RunWait	Запускает внешнюю программу и ждет завершения ее исполнения.	Target,WorkingDir, |Max|Min|Hide|UseErrorLevel, OutputVarPID
Send	Посылает активному окну эмулированные нажатия клавиш.	Keys
SendRaw	Посылает активному окну эмулированные нажатия клавиш.	Keys
SendMessage	Посылает окну или элементу управления сообщение и ждет подтверждение приема.	Msg, wParam, lParam,Control,WinTitle,WinText,ExcludeTitle,ExcludeText
SetBatchLines	Определяет, как быстро будет выполняться скрипт (влияет на коэффициент загрузки центрального процессора).	20ms/LineCount
SetCapslockState	Задает состояние клавиши Capslock. Может включать ее или выключать.	|On|Off|AlwaysOn|AlwaysOff
SetControlDelay	Задает задержку после каждой команды, влияющей на элементы управления.	Delay
SetDefaultMouseSpeed	Задает скорость мыши, если она не была определена в командах MouseMove/Click/Drag.	Speed
SetFormat	Задает формат получаемых в результате математических операций целых чисел и чисел с плавающей запятой.	INTEGER|FLOAT, Format
SetKeyDelay	Задает задержку после каждого нажатия клавиши, посланного командой Send или ControlSend.	Delay, PressDuration,Play
SetMouseDelay	Задает задержку после каждого движения или щелчка мыши.	Delay,Play
SetNumlockState	Задает состояние клавиши Numlock. Может включать ее или выключать.	|On|Off|AlwaysOn|AlwaysOff
SetScrollLockState	Задает состояние клавиши Scrolllock. Может включать ее или выключать.	|On|Off|AlwaysOn|AlwaysOff
SetStoreCapslockMode	Определяет, восстанавливать ли после команды Send состояние клавиши CapsLock.	On|Off
SetTimer	Многократно автоматически запускает подпрограмму в заданные промежутки времени.	Label, |Period|On|Off, Priority
SetTitleMatchMode	Задает соответствующее поведение параметра WinTitle в таких командах, как WinWait.	|1|2|3|Fast|Slow
SetWinDelay	Задает задержку после каждой команды, управляющей окнами, такой, как WinActivate.	Delay
SetWorkingDir	Изменяет текущий рабочий каталог скрипта.	DirName
Shutdown	Завершает работу (shut down) системы, перезапускает (restart) систему или выходит из системы (log off).	Code
Sleep	Перед продолжением работы, выжидает заданное количество времени.	Delay
Sort	Располагает содержимое переменной в алфавитном, числовом или случайном порядке (по желанию удаляет копии).	VarName, |C|CL|Dx|N|Pn|R|Random|U|Z|\
SoundBeep	Издает звук из динамика ПК.	Frequency, Duration
SoundGet	Извлекает из звукового устройства различные настройки (приглушение звука, громкость и т.д.)	OutputVar, |MASTER|DIGITAL|LINE|MICROPHONE|SYNTH|CD|TELEPHONE|PCSPEAKER|WAVE|AUX|ANALOG, |VOL|ONOFF|MUTE|MONO|LOUDNESS|STEREOENH|BASSBOOST|PAN|QSOUNDPAN|BASS|TREBLE|EQUALIZER, DeviceNumber
SoundGetWaveVolume	Извлекает из звукового устройства волновую выходную громкость.	OutputVar, DeviceNumber
SoundPlay	Проигрывает звук, видео и другие поддерживаемые типы файлов.	Filename, wait
SoundSet	Изменяет различные настройки звукового устройства (приглушение звука, громкость и т.д.)	NewSetting, |MASTER|DIGITAL|LINE|MICROPHONE|SYNTH|CD|TELEPHONE|PCSPEAKER|WAVE|AUX|ANALOG, |VOL|ONOFF|MUTE|MONO|LOUDNESS|STEREOENH|BASSBOOST|PAN|QSOUNDPAN|BASS|TREBLE|EQUALIZER, DeviceNumber
SoundSetWaveVolume	Изменяет волновую выходную громкость звукового устройства.	Percent, DeviceNumber
SplashImage	Создает или обновляет окно, содержащее JPG, GIF или BMP изображения.	ImageFile, Options, SubText, MainText, WinTitle,FontName,FutureUse
SplashTextOn	Создает настраиваемый текст всплывающего окна.	Width, Height, Title, Text
SplashTextOff	Закрывает все ранее открытые окна.	0
SplitPath	Разделяет имя файла или URL на имя, каталог, расширение и диск.	InputVar, OutFileName, OutDir, OutExtension, OutNameNoExt, OutDrive
StatusBarGetText	Извлекает текст из стандартного элемента управления "строка состояния" (status bar).	OutputVar, Part#,WinTitle,WinText,ExcludeTitle,ExcludeText
StatusBarWait	Ожидает появления в строке состояния окна заданной строки.	BarText, Seconds, Part#,WinTitle,WinText, Interval,ExcludeTitle,ExcludeText
StringCaseSense	Определяет, является ли сравнение строк чувствительным к регистру (по умолчанию "no").	On|Off|Locale
StringGetPos	Извлекает позицию заданной подстроки в строке.	OutputVar, InputVar, SearchText, |L#|R#, Offset
StringLeft	Извлекает заданное количество символов в левой части строки.	OutputVar, InputVar, Count
StringLen	Определяет количество символов в строке.	OutputVar, InputVar
StringLower	Конвертирует строку в нижний регистр.	OutputVar, InputVar,T
StringMid	Извлекает из заданной позиции в строке один или несколько символов.	OutputVar, InputVar, StartChar, Count ,L
StringReplace	Заменяет заданную подстроку новой строкой.	OutputVar, InputVar, SearchText, ReplaceText, |1|A
StringRight	Извлекает заданное количество символов в правой части строки.	OutputVar, InputVar, Count
StringSplit	Разделяет строку на массив подстрок при помощи заданного разделителя.	OutputArray, InputVar, Delimiters, OmitChars,FutureUse
StringTrimLeft	Удаляет некоторое количество символов из левой части строки.	OutputVar, InputVar, Count
StringTrimRight	Удаляет некоторое количество символов из правой части строки.	OutputVar, InputVar, Count
StringUpper	Конвертирует строку в верхний регистр.	OutputVar, InputVar,T
Suspend	Блокирует или разблокирует все выбранные горячие клавиши.	on|off|toggle|default
SysGet	Извлекает разрешение экрана, информацию о мониторах, размерность системных объектов и другие системные свойства.	OutputVar, |MonitorCount|MonitorPrimary|Monitor|MonitorWorkArea|MonitorName, Param3
Thread	Задает приоритет или возможность прерывания потоков. Может также временно заблокировать все таймеры.	NoTimers*false|Priority*n|Interrupt*Duration*LineCount
ToolTip	Создает в любом месте экрана окно, всегда расположенное поверх других окон.	Text, X, Y, WhichToolTip
Transform	Исполняет различные математические функции, побитовые операции и такие задачи, как преобразования ASCII/Unicode.	OutputVar, Cmd, Value1, Value2
TrayTip	Создает рядом с иконкой в трее всплывающее окно сообщений. Требует Windows 2000/XP или более поздних версий.	Title, Text, Seconds, |1|2|3
URLDownloadToFile	Загружает из Интернета файл.	URL,Filename
VarSetCapacity(	Увеличивает ёмкость переменной или освобождает ее память. Обычно данная команда необходима только в чрезвычайных случаях, таких, как при вызове DllCall().	GrantedCapacity, UnquotedVarName, RequestedCapacity, FillByte)
WinActivate	Активирует заданное окно (перемещает его на передний план).	WinTitle,WinText,ExcludeTitle,ExcludeText
WinActivateBottom	То же самое, что и WinActivate, только активирует самое нижнее подходящее окно (самое первое из недавно открытых), а не окно, находящееся на самом верху.	WinTitle,WinText,ExcludeTitle,ExcludeText
WinClose	Закрывает все заданные окна.	WinTitle,WinText,SecondsToWait,ExcludeTitle,ExcludeText
WinGetActiveStats	Комбинирует функции WinGetActiveTitle и WinGetPos в одну команду.	Title, Width, Height, X, Y
WinGetActiveTitle	Извлекает название активного окна.	OutputVar
WinGetClass	Извлекает имя класса заданного окна.	OutputVar,WinTitle,WinText,ExcludeTitle,ExcludeText
WinGet	Извлекает уникальный идентификатор, идентификатор процесса, имя процесса или список элементов управления заданного окна. Может также извлекать список всех окон, подпадающих под определенные критерии.	OutputVar, |ID|IDLast|PID|ProcessName|Count|List|MinMax|ControlList|ControlListHwnd|Transparent|TransColor|Style|ExStyle,WinTitle,WinText,ExcludeTitle,ExcludeText
WinGetPos	Извлекает позицию и размер заданного окна.	X, Y, Width, Height,WinTitle,WinText,ExcludeTitle,ExcludeText
WinGetText	Извлекает из заданного окна текст.	OutputVar,WinTitle,WinText,ExcludeTitle,ExcludeText
WinGetTitle	Извлекает заголовок заданного окна.	OutputVar,WinTitle,WinText,ExcludeTitle,ExcludeText
WinHide	Скрывает заданное окно.	WinTitle,WinText,ExcludeTitle,ExcludeText
WinKill	Закрывает заданное окно.	WinTitle,WinText, SecondsToWait,ExcludeTitle,ExcludeText
WinMaximize	Увеличивает заданное окно до максимального размера.	WinTitle,WinText,ExcludeTitle,ExcludeText
WinMenuSelectItem	Запускает пункт меню из строки меню заданного окна.	WinTitle,WinText, Menu, SubMenu1, SubMenu2, SubMenu3, SubMenu4, SubMenu5,ExcludeTitle,ExcludeText
WinMinimize	Сворачивает заданное окно в кнопку на панели задач.	WinTitle,WinText,ExcludeTitle,ExcludeText
WinMinimizeAll	Минимизирует все окна.	0
WinMinimizeAllUndo	Отменяет результат выполнения предыдущей команды WinMinimizeAll.	0
WinMove	Изменяет позицию и/или размер заданного окна.	WinTitle,WinText, X, Y, Width, Height,ExcludeTitle,ExcludeText
WinRestore	Отменяет команды WinMinimize и WinMaximize для заданного окна.	WinTitle,WinText,ExcludeTitle,ExcludeText
WinSet	Вносит в заданное окно различные изменения, такие, как прозрачность и "всегда поверх других окон".	Attribute, Value,WinTitle,WinText,ExcludeTitle,ExcludeText
WinSetTitle	Изменяет заголовок заданного окна.	WinTitle,WinText, NewTitle,ExcludeTitle,ExcludeText
WinShow	Показывает скрытое заданное окно.	WinTitle,WinText,ExcludeTitle,ExcludeText
WinWait	Ожидает появления заданного окна.	WinTitle,WinText, Seconds,ExcludeTitle,ExcludeText
WinWaitActive	Ожидает активизации заданного окна.	WinTitle,WinText, Seconds,ExcludeTitle,ExcludeText
WinWaitClose	Ожидает исчезновения (закрытия) заданного окна.	WinTitle,WinText, Seconds,ExcludeTitle,ExcludeText
WinWaitNotActive	Ожидает деактивизации заданного окна.	WinTitle,WinText, Seconds,ExcludeTitle,ExcludeText
#AllowSameLineComments	Только для скриптов AutoIt v2 (.aut): разрешает комментарии на одной строке с командой.	0
#ClipboardTimeout	Изменяет время, в течение которого скрипт пытается открыть буфер обмена.	Milliseconds
#CommentFlag	Изменяет символ комментария скрипта с точки с запятой на другую последовательность символов.	NewString
#ErrorStdOut	Посылает любую синтаксическую ошибку, мешающую запуску скрипта, в stdout, не выводя на экран диалог.	0
#EscapeChar	Изменяет escape-символ скрипта (например: знак акцента на обратный слеш).	NewChar
#HotkeyInterval	Вместе с директивой #MaxHotkeysPerInterval определяет частоту активаций горячей клавиши, при превышении которой на экран выводится предупреждающий диалог.	Milliseconds
#HotkeyModifierTimeout	Воздействует на поведение модификаторов горячих клавиш: CTRL, ALT, WIN и SHIFT.	Milliseconds
#Hotstring	Изменяет опции или завершающие символы строки автозамены.	NoMouse|EndChars*NewChars|NewOptions
#Include	Заставляет скрипт вести себя так, как будто содержимое заданного файла находится точно на данной позиции.	Filename|DirName
#InstallKeybdHook	Безусловно устанавливает обработчик клавиатурных прерываний.	0
#InstallMouseHook	Безусловно устанавливает обработчик прерываний мыши.	0
#KeyHistory	Задает максимальное количество событий клавиатуры и мыши, отображаемые окном KeyHistory. Чтобы заблокировать key history, задайте значение 0.	MaxEvents
#MaxHotkeysPerInterval	Вместе с директивой #HotkeyInterval задает частоту активаций горячей клавиши, при превышении которой на экран выводится предупреждающий диалог.	Milliseconds
#MaxMem	Задает максимальную ёмкость каждой переменной (в мегабайтах).	Megabytes
#MaxThreads	Задает максимальное количество одновременно исполняемых потоков.	Value
#MaxThreadsBuffer	Буферизует некоторые или все горячие клавиши по достижении максимального количества одновременных потоков на горячую клавишу, установленного #MaxThreadsPerHotkey (горячие клавиши не игнорируют нажатия клавиш).	On|Off
#MaxThreadsPerHotkey	Задает максимальное количество одновременных потоков на горячую клавишу.	Value
#NoTrayIcon	Блокирует вывод иконки в трее.	0
#Persistent	Удерживает скрипт в постоянно запущенном состоянии (т.е. до тех пор, пока его не закроет пользователь или пока исполнение скрипта не дойдет до команды ExitApp).	0
#SingleInstance	Мешает одновременному существованию нескольких экземпляров скрипта.	|force|ignore|off
#UseHook	Заставляет использовать обработчик прерываний при выполнении всех или некоторых горячих клавиш клавиатуры.	On|Off
#WinActivateForce	Пропускает стандартный (gentle) метод активации окна, переходя прямо к интенсивному (forceful) методу.	0
